ADJ	ADJ
ADJFP	ADJ
ADJFS	ADJ
ADJMP	ADJ
ADJMS	ADJ
ADV	ADV
AUX	AUX
CHIF	NUM
COCO	CCONJ
COSUB	SCONJ
DET	DET
DETFS	DET
DETMS	DET
DINTFS	DET
DINTMS	DET
INTJ	INTJ
MOTINC	X
NFP	NOUN
NFS	NOUN
NMP	NOUN
NMS	NOUN
NOUN	NOUN
NUM	NUM
PART	PART
PDEMFP	PRON
PDEMFS	PRON
PDEMMP	PRON
PDEMMS	PRON
PINDFP	PRON
PINDFS	PRON
PINDMP	PRON
PINDMS	PRON
PPER1S	PRON
PPER2S	PRON
PPER3FP	PRON
PPER3FS	PRON
PPER3MP	PRON
PPER3MS	PRON
PPOBJFP	PRON
PPOBJFS	PRON
PPOBJMP	PRON
PPOBJMS	PRON
PREF	PRON
PREFP	PRON
PREFS	PRON
PREL	PRON
PRELFP	PRON
PRELFS	PRON
PRELMP	PRON
PRELMS	PRON
PREP	ADP
PRON	PRON
PROPN	PROPN
PUNCT	PUNCT
SYM	SYM
VERB	VERB
VPPFP	VERB
VPPFS	VERB
VPPMP	VERB
VPPMS	VERB
X	X
XFAMIL	PROPN
YPFOR	PUNCT
